################
#      @       #
#xxxxxxxxxxxxxx#
# # # # # # # ##
#              #
#              #
#              #
#              #
#              #
#              #
#              #
#              #
#              #
#              #
#              #
################
